1111111111111
1000000000001
1000000000001
1000000000001
1101110000001
1110000000001
1000X00000001
1111111111111
