11111111
1X000001
10000001
10000001
11010001
11101001
11001011
11111111
