11111111
10000001
10000001
10000001
11010001
11100001
11000001
11111111
