11111111111111
10000000000001
10011100111001
10010000001001
100111X0111001
10000000001001
10000020000001
11111111111111
