1111111111111
1X00000000001
1000000000001
1000000000001
1101110000001
1110000000001
1000000000001
1111111111111
